** ** ** ** ** ** ** ** ** ** ** ** ** ** ** ** ** ** 26 ** ** ** ** ** ** ** ** ** ** ** ** ** ** ** ** ** ** ** ** ** ** ** ** ** ** ** ** ** 26 ** ** ** ** ** ** ** ** ** ** ** ** ** ** ** **
** ** ** ** ** ** ** ** ** ** ** ** ** ** 26 ** ** ** ** ** ** 26 26 ** ** 26 ** ** ** ** ** ** ** ** ** ** ** ** ** ** ** ** ** ** ** 26 ** ** ** ** ** 26 26 ** ** 26 ** ** ** ** ** ** ** ** **
** ** ** ** ** ** ** ** ** ** ** ** ** ** 01 01 ** ** ** ** ** 01 01 01 01 01 ** ** ** ** ** ** ** ** ** ** ** ** ** ** ** ** ** ** 01 01 ** ** ** ** ** 01 01 01 01 01 26 ** 26 26 ** ** ** ** **
** ** ** ** ** ** ** ** ** ** ** ** ** ** ** ** ** ** 01 01 ** ** ** ** ** ** ** ** ** ** ** ** ** ** ** ** ** ** ** ** ** ** ** ** 26 26 ** ** 01 01 ** ** ** ** ** ** ** ** ** ** ** ** 10 ** **
** ** ** ** ** ** ** ** ** ** ** ** ** ** ** ** ** ** ** ** ** ** ** ** ** ** ** ** ** ** ** ** ** ** ** ** ** ** ** ** ** ** ** 01 01 01 ** ** ** ** ** ** ** ** ** ** 01 01 01 01 01 ** ** ** **
** ** ** ** ** ** ** ** ** ** ** ** ** ** ** 01 01 ** ** ** ** ** ** ** ** ** ** ** ** ** ** ** ** ** ** ** ** ** ** ** ** ** ** ** ** ** ** ** ** ** ** ** ** ** ** ** ** ** ** ** ** ** ** ** **
** 26 26 26 26 26 ** ** 26 26 26 26 ** ** 26 26 26 26 26 26 26 ** ** ** ** ** ** ** ** ** ** ** ** ** ** ** ** 26 26 26 26 ** ** 26 26 26 26 26 26 26 26 26 26 26 26 26 26 26 26 26 26 26 26 26 **
00 01 01 01 01 01 01 01 01 01 01 01 01 01 01 01 01 01 01 01 01 01 01 01 01 01 01 01 01 02 ** ** ** ** ** 00 01 01 01 01 01 01 01 01 01 01 01 01 01 01 01 01 01 01 01 01 01 01 01 01 01 01 01 01 02
09 10 10 10 10 10 10 10 10 10 10 10 10 10 10 10 10 10 10 10 10 10 10 10 10 10 10 10 10 11 26 26 26 26 26 09 10 10 10 10 10 10 10 10 10 10 10 10 10 10 10 10 10 10 10 10 10 10 10 10 10 10 10 10 11
09 10 10 10 10 10 10 10 10 10 10 10 10 10 10 10 10 10 10 10 10 10 10 10 10 10 10 10 10 11 01 01 01 01 01 09 10 10 10 10 10 10 10 10 10 10 10 10 10 10 10 10 10 10 10 10 10 10 10 10 10 10 10 10 11
09 10 10 10 10 10 10 10 10 10 10 10 10 10 10 10 10 10 10 10 10 10 10 10 10 10 10 10 10 11 10 10 10 10 10 09 10 10 10 10 10 10 10 10 10 10 10 10 10 10 10 10 10 10 10 10 10 10 10 10 10 10 10 10 11
22 23 23 23 23 23 23 23 23 23 23 23 23 23 23 23 23 23 23 23 23 23 23 23 23 23 23 23 23 24 22 23 23 23 24 22 23 23 23 23 23 23 23 23 23 23 23 23 23 23 23 23 23 23 23 23 23 23 23 23 23 23 23 23 24