** ** ** ** ** ** ** ** ** ** ** ** ** ** ** ** ** ** 28 ** ** ** ** ** ** ** ** ** ** ** ** ** ** ** ** ** ** ** ** ** ** ** ** ** ** ** ** ** 28 ** ** ** ** ** ** ** ** ** ** ** ** ** ** ** **
** ** ** ** ** ** ** ** ** ** ** ** ** ** 26 ** ** ** ** ** ** 26 26 ** ** 26 ** ** ** ** ** ** ** ** ** ** ** ** ** ** ** ** ** ** ** 26 ** ** ** ** ** 26 26 ** ** 26 ** ** ** ** ** ** ** ** **
** ** ** ** ** ** ** ** ** ** ** ** ** ** 12 14 ** ** ** ** ** 12 13 13 13 14 ** ** ** ** ** ** ** ** ** ** ** ** ** ** ** ** ** ** 12 14 ** ** ** ** ** 12 13 13 13 14 28 ** 28 28 ** ** ** ** **
** ** ** ** ** ** ** ** ** ** ** ** ** ** ** ** ** ** 12 14 ** ** ** ** ** ** ** ** ** ** ** ** ** ** ** ** ** ** ** ** ** ** ** ** 26 26 ** ** 12 14 ** ** ** ** ** ** ** ** ** ** ** ** 27 ** **
** ** ** ** ** ** ** ** ** ** ** ** ** ** ** ** ** ** ** ** ** ** ** ** ** ** ** ** ** ** ** ** ** ** ** ** ** ** ** ** ** ** ** 12 13 14 ** ** ** ** ** ** ** ** ** ** 12 13 13 13 14 ** ** ** **
** ** ** ** ** ** ** ** ** ** ** ** ** ** ** 12 14 ** ** ** ** ** ** ** ** ** ** ** ** ** ** ** ** ** ** ** ** ** ** ** ** ** ** ** ** ** ** ** ** ** ** ** ** ** ** ** ** ** ** ** ** ** ** ** **
** 26 26 26 26 26 ** ** 26 26 26 26 ** ** 26 26 26 26 26 26 26 ** ** ** ** ** ** ** ** ** ** ** ** ** ** ** ** 26 26 26 26 ** ** 26 26 26 26 26 26 26 26 26 26 26 26 26 26 26 26 26 26 26 26 26 **
00 01 01 01 01 01 01 01 01 01 01 01 01 01 01 01 01 01 01 01 01 01 01 01 01 01 01 01 01 02 ** ** ** ** ** 00 01 01 01 01 01 01 01 01 01 01 01 01 01 01 01 01 01 01 01 01 01 01 01 01 01 01 01 01 02
09 10 10 10 10 10 10 10 10 10 10 10 10 10 10 10 10 10 10 10 10 10 10 10 10 10 10 10 10 11 26 26 26 26 26 09 10 10 10 10 10 10 10 10 10 10 10 10 10 10 10 10 10 10 10 10 10 10 10 10 10 10 10 10 11
09 10 10 10 10 10 10 10 10 10 10 10 10 10 10 10 10 10 10 10 10 10 10 10 10 10 10 10 10 20 01 01 01 01 01 19 10 10 10 10 10 10 10 10 10 10 10 10 10 10 10 10 10 10 10 10 10 10 10 10 10 10 10 10 11
09 10 10 10 10 10 10 10 10 10 10 10 10 10 10 10 10 10 10 10 10 10 10 10 10 10 10 10 10 10 10 10 10 10 10 10 10 10 10 10 10 10 10 10 10 10 10 10 10 10 10 10 10 10 10 10 10 10 10 10 10 10 10 10 11
22 23 23 23 23 23 23 23 23 23 23 23 23 23 23 23 23 23 23 23 23 23 23 23 23 23 23 23 23 23 23 23 23 23 23 23 23 23 23 23 23 23 23 23 23 23 23 23 23 23 23 23 23 23 23 23 23 23 23 23 23 23 23 23 24